12,10,10,10,10,10,10,10,10,14
3,2,2,2,2,2,2,2,2,3
3,2,9,11,2,2,9,11,2,3
3,2,2,2,2,2,2,2,2,3
3,2,9,11,2,2,9,11,2,3
3,8,2,2,2,2,2,2,8,3
15,11,2,0,-1,-1,0,2,9,17
3,2,2,3,-1,-1,3,2,2,3
15,11,2,18,10,10,20,2,9,17
3,8,2,2,2,2,2,2,8,3
3,2,9,11,2,2,9,11,2,3
3,2,2,2,2,2,2,2,2,3
3,2,9,11,2,2,9,11,2,3
3,2,2,2,2,2,2,2,-1,3
18,10,10,10,10,10,10,10,10,20
